****##**************************************************************#******************#************
****#******************************************+++++************************************************
#*********************************++=--=+**=:-**-**-:=**++=--=+*************************************
****************************+=--=+*+::+*####*############*+-:+*+==--=+****+==*+=:...+***************
*********************+==-=++-:=**########################*+=++:..:-.=:.:==:.-=-:=++-****************
***************+=--==-.-+**###%%%%%%###*###=-+*-...-=:.++-:-::=+=:.=-::::=::=::+=:::****************
*********=====-:===+*##*+=--*-:..:+*-:::::+::=-:+#*+#=-:--*-:+#**::=:-+---:=*-:=#=--=====***********
******=--=+=+#**=-:-:-+--=++=--*=--+-:==-+=-:*+--::***=-=%*---##=--+-:*#=---**=--==+#+=+=::=********
*****-=:-#%%%%%+--+%#%-==-:#-=---+#===+=-==--=*%*=-*%#-=+%%#+===++%+++%#%##%%###*#%%%%%#*==*-+:..-**
****---#%%%%%%%+*+=-:====*#+=-+==-+==--==*=-+++==+#%%**+%%%+++=*%%#%%%%%%%%%%=...=%%%*::..++++:..+**
***=++#%%%%%%%%+:+++=++===-++-**+++****###*##*++#%%%##**+=+:..*-:......+%%%%+=::.:%%%+:::..-*=:::*##
***-::*%%%%%%%******#####*#*+%%+*%%@%%%%*=:.+%*-:.....::::-:.-+:::===::.#%%+=--::.*%=-----:.=:::-#**
***=+*#%%%%%%%%#*#%#*++%%%%+:......=%%%+=::.:*+==+---=****-::=+--:++----%%+=::*::.:#+---*+----::+***
***==:--%%+:.:-%%%+=:..+%%#=---++-::=%*=---:.+#*%#---+#%%*--:*+----::=+%%*=---:=-:.**--:#%*=---:*#**
###=-:.=#-=--*%%%+=---:-%@*-=--**==-**+--*--:=%%#+==-#%%*==-:*======-:*%++==+***==-=+==:%+##===-##**
###*=-:=--==%%%%*+==+=-:#%*===-====+*+===-==-:%%#===:%%%#-=-=#==-##===-*+==+##%%++***##*%%#%%#*#####
###+==-====%%%%*+=-=-==-=#====****@*++=++++==-+%*-===%%#+=+=#+++=*##**#***#@%%#+++###%%%%%%#**=#####
##+=+=-++=-+%@+++++++++=:*=++-#%@@*++=++=**+++=#*+*+%@@+**=%=+=*@%*##%#%%@%%%%%%%%%%%%%%@%%#=+=#####
##*=+-#*++=-**++=##%%+=+=*+++*@@@%***#@@@#%###@++*%@@@@%%@@@@@@@@@@@@@@@@@%%##*=%=:%%%%@@@%+==+#####
#+=++-=+**+++++*+@@%+***#*+=@@@@%#%@@@@%%@@@@@@@@@@@@@@@@%%%@*=+%:..-:. .=.:-.=.::%%%@@@@%*-::#%####
#%%##=*#%####**@@@@@@@@%%@@@@@@@@@@@@+....*%++##:..=...+.:.::.=*.-+.+.==.=.=.-*.:@@@@%%##=+=-#%#%###
###%%%#-+**-***+#%%@@%..-@#*+=#*...*%-.:...:*.-.+=.+:..::+.=.:.=-.::*:*++****%-:%%#*=:-++=-*%%%%%%%%
%%%%%%%%%%*===-:=*=**:::.#::+.=.*:.%%::#%#.::.#::.=+-=#%*#%###@*##%%%@@@%%%%#*=+*+=+=-=*%%%%%%%%%%%%
%%%%%%%%%%%@@@@@#+==..-:.=.=::*::.=@+=#@%=*++%=.:-##%@@@@@@@@@@@@%%%#*=-+*=+*+-=+#@@@@@@%%%%%%%%%%%%
%%%%%%%%%%%@@@@@@@@=+##+*+#*+#=.:-#%%%%%%@@@@#**%@@@@@@@@%%%%#*++**-*+-:=+*%@@@@@@@@@@@@@%%%%%%%%%%%
%%%%%%%%%%%@@@@@@@%%@@@@@@@@@###*+**-++--+####%#######*=+**==*=:--+*%@@@@@@@@@@@@@@@@@@@@%%%%%%%%%%%
%%%%%%%%%%%@@@@@@@@@@@@@@@@@@@@@@@@%#*=--=++=**-.=*++*+----=*#%@@@@@@@@@@@@@@@@@@@@@@@@@%%%%%%%%%%%%
%%%%%%@%@@@@@@@@@@@@@@@@@@@@@@@@@@@@@@@@@@@@@@@%%%%@@@@@@@@@@@@@@@@@@@@@@@@@@@@@@@@@@@@%%%%%%%%%%%@@
%%%%%@%%%%@@@@@@@@@@@@@@@@@@@@@@@@@@@@@@@@@@@@@@@@@@@@@@@@@@@@@@@@@@@@@@@@@@@@@@@@@@@%%@%%%%%%%%%@%%